WWWWWWWWWWWWWWWWWWWW
W.   W        W   .W
W 1W W WWWWWW W W2 W
W W              W W
W W WW WggggW WW W W
W     /WWWWWW/     W
W W WW        WW W W
W W              W W
W 4W W WWWWWW W W3 W
W.   W    p   W   .W
WWWWWWWWWWWWWWWWWWWW
