WWWWWWWWWWWWWWWWW
W.   WW        .W
W 1W     W WWWW W
W    WWW W    W W
WWW WW     WW   W
/      WgW    W W
W WWWW WWW WW   W
W       W     WWW
W WW WW   WWW W/W
W WW WWW WWWW W W
W.      p      .W
WWWWWWWWWWWWWWWWW
