WWWWWWWWWWWWWWWWWWWWWWWWWWW
W            W            W
W.W1WW WWWWW W WWWWW WW2W.W
W WWWW WWWWW W WWWWW WWWW W
W                         W
W WWWW W WWWWWWWWW W WWWW W
W      W     W     W      W
WWWWWW WWWWW W WWWWW WWWWWW
-----W W           W W-----
WWWWWW W WWggWggWW W WWWWWW
W/       W-------W       /W
WWWWWW W WWWWWWWWW W WWWWWW
-----W W           W W-----
WWWWWW W WWWWWWWWW W WWWWWW
W            W            W
W WWWW WWWWW W WWWWW WWWW W
W. WWW       p       WWW .W
WW WWW WW WWWWWWW WW WWW WW
W      WW    W    WW      W
W W4WWWWWWWW W WWWWWWWW3W W
W                         W
WWWWWWWWWWWWWWWWWWWWWWWWWWW
